%%%%%%%
%     %
% %%% %
% %.% %
%   % %
%  %% %
%P    %
%%%%%%%